111111111111111111111111111
1P0000000000000000000000011
101111101111101111101111101
100000000001000000000000001
101101111101011101111101111
100100001000010000000000001
101101101111010111101111101
100001000000010000001000001
101101101111111011101111101
1C0000000000000000000000E01
101111111101111101111111101
100000000000000000000000001
111111111111111111111111111