1111111111111111111111111111111111
1P000C000000C000000C000000C000E111
1011111011111101111110111110111101
1000001000000001000000100000001001
1011111011111101011110111110111101
1000100010000001000100000000100001
1010111110111111011110111110111101
1C000000000000000000000000000000C1
1010111110111111011110111110111101
1000100010000001000100000000100001
1011111011111101011110111110111101
1000001000000001000000100000001001
1011111011111101111110111110111101
10000C000000C000000C000000C0000011
1111111111111111111111111111111111