111111111111111111
1C0000000000000001
100111100111110001
100000100000000001
101111101111101101
100000100000100001
101111101011110101
1000000P0000000001
100011111111110E01
111111111111111111