111111111111111111111
1P0000000000110000011
101111011101011011101
100001010000010000001
101101010111010111101
100101010100000100001
100101010101110101101
100100010001010001001
101111111101010111101
1C0000000000000100001
101101111101111110101
100001000001000000E01
111111111111111111111