1111111111111111
1C100000000001E1
1111111011110101
1000001000010001
1011101010010001
1000010000000001
1P01110000000001
1111111111111111