1111111111111111
1C000E0000000001
10111110111100011
1000001000010001
1011101010010001
1000010000000001
1P01110000000001
1111111111111111