1111111111111111
10000E0000000001
1011111011110001
1000001000010001
1011101010010001
1000010000000001
1P01110000000001
1111111111111111