1111111111111111111111111111111111
1P000C000000C000000C000000C000E111
1011111011111101111110111110111101
100000100X000001000000100X00011001
1011111011111101011110111110111101
1000100010000001000100000000100001
1010111110111111C11110111110111101
1C0000000000000CXC00000000000000C1
1010111110111111C11110111110111101
1000100010000001000100000000100001
1011111011111101011110111110111101
1000001X000000010000001000X0001001
1011111011111101111110111110111101
10000C000000C000000C000000C0000011
1111111111111111111111111111111111