1111111111111111
1P0000C0000000E1
1X11111011111101
1000001010000001
1011101010111101
1010001010000101
1010111111100101
1C0000000000C0X1
1010111111100101
1010001010000101
1011101010111101
1000001010000001
1011111011111101
1X000000C0000001
1111111111111111