1111111111111111111
1P000000C00000000E1
1011111111011111111
1000000001010000001
1011111101010111111
1000010000000001001
1011010111110101011
1C000001000010000C1
1011110111011101111
1000010001000100001
1011011101010110111
1000000001010000001
1011111111011111111
1X000C000C000C000X1
1111111111111111111