1111111111111111111111111111111111
1P000000C000000C000000C00000000E11
1011111011111011111101111011111101
1000001000001000000001000000000001
1011111011111111011110111111011111
1000001000000001000000100000000001
1011111111111101111110111111111111
1C000000000000000000000000000000C1
1011111111111101111110111111111111
1000001000000001000000100000000001
1011111011111111011110111111011111
1000001000000001000000100000000001
1011111011111011111101111011111101
1X000C000000C000000C000000C00000X1
1111111111111111111111111111111111