1111111111111111111111111111111111111111
1P0000C000000000000C00000000000000000E11
1011111110111111011111011111011111011101
10000000001000000100000100000000000X0001
1011111111111111011111011111111111011101
1000000000X00000000000000000000000000001
1011111011111111011111011111111111011101
1000001000000001000100000000000000000001
1011111111111101111110111111111111111101
1000X000000000000000X0000000000000000001
1011111111111101111110111111111111111101
10000010000000010001000000000000X0000001
1011111011111111011111011111111111011101
10000000000000000000X0000000000000000001
1011111110111111011111011111011111011101
1X000000C000000X00000C00000000000000X111
1111111111111111111111111111111111111111