1111111111111111111111111
1000000000000000000000001
100X000C00000000000000001
100000000000000X000000001
10000000000000C0000000001
100000000000000000000X001
100000000000000000000E001
1000000000000000000000001
1000000P000000X0000000001
1111111111111111111111111